00000000000000000000
11100000000000000000
00100000000000000000
00111111000000000000
00000001111111100000
00000000000001100000
00000000000000100000
00000000000000100000
00000001001000100000
00000000000000100000
00000000000000111100
00000000000000000100
00000000000000000100
00000000000100000110
00000000000000000010
00000000000000000011
00000000000100000000
00000000000000000000
00000000000000000000
00000000000000000000
